0000000000000000000000000000000000000000000000000000000000000003
0                      0                                      00
0 1             0                                              0
0                                                              0
0                                                              0
0                                                              0
0                                                              0
0                                                              0
0                                                              0
0                                                              0
0                                                              0
0                                                              0
0                                                              0
0                                                              0
0                                                              0
0                                                              0
0                                                              0
0                                                              0
0                                                              0
0                                                              0
0                                                          9   0
0000000000000000000000000000000000000000000000000000000000000000
